000000000000000000000000000000000000000000000000000000000000000000000000000000000000000000000000000
100000000000000000000000000000000000000000000000000000000000000000000000000000000000000000000000001
100000000000000000000000000000000000000000000000000000000000000000000000000000000000000000000000001
100000000000000200000000000000000000000000000000000000000000000000000000000000000000000000000000221
100000000000000100000000000000000000000000000000000000000000000000000022220000000000000000000000111
100000000000002100000000000000000000000000000000000000000000000000000011110000000000000000000200001
120000000000221100000000022000000000000000000000000000000000000000000000000000000000000000000100001
112222222222111100000022011000000000000000000000000002002200220020022200002222000000000002000000001
101111111111111100000011000000000000000000000000002201001100110010011100001111000000000001000000001
100000000000000000000000000000000000000000000000001100000000000000000000000000000000000200000000001
100000000000000000000000000002222222222222200002000000000000000000000000000000002222000100000000001
100000000000000000000000000001111111111111100001000000000000000000000000000000001111000000000000001
100000000000000000000000000000000000000000000000000000000000000000000000000000000000000000000000001